#######
#     #
#  @$ #
#  $  #
#  .  #
#######
