########
#  @   #
#  $   #
#  $   #
# ..   #
#      #
########
