########
#  @   #
#  $ $ #
#  ### #
# ..   #
#      #
########